sssssssssssssssssss
s.................s
s.................s
s.................s
s......tttttttt...s
s......tmmmmmmt...s
s......t......t...s
s.............TTTTs
s...........f.....s
s.................s
s.................s
s.................s
s.........p..w.w..s
sssssssssssssssssss